1111111111111
1001000000001
10000P000C001
10C0000000001
1000011111001
101011E00C001
1111111111111
