1111111111111
1001000000001
100000000C001
10C000000P001
1000011111001
101011E00C001
1111111111111
