1111111111111
1001000000001
10T000000C001
10C00T000P001
1000011111001
101T11E00C001
1111111111111