11111111111111111111
1E0000000T00000C0001
1T100001001000001011
10100101001000001011
1010T101001000001011
10100101001000001011
10100101001000001011
101001T1001000001011
10100100101010100001
1P0000000C00CT000001
11111111111111111111